Rk,Player,Nation,Pos,Squad,Age,Born,90s,Tkl_tackles,TklW_tackles,Def 3rd_tackles,Mid 3rd_tackles,Att 3rd_tackles,Tkl_challenges,Att_challenges,Tkl%_challenges,Lost_challenges,Blocks_blocks,Sh_blocks,Pass_blocks,Int,Tkl+Int,Clr,Err
1,Junior Adamu,AUT,FW,Freiburg,23,2001.0,4.5,0,0,0,0,0,0,0,0.0,0,3,0,3,2,2,4,0
2,Karim Adeyemi,GER,"FW,MF",Dortmund,22,2002.0,3.4,7,5,3,1,3,2,2,100.0,0,6,0,6,1,8,0,0
3,Amine Adli,MAR,"MF,FW",Leverkusen,24,2000.0,1.4,4,2,0,1,3,1,2,50.0,1,2,0,2,0,4,2,0
4,Oladapo Afolayan,ENG,FW,St. Pauli,26,1998.0,3.1,4,2,1,2,1,1,2,50.0,1,2,0,2,2,6,3,0
5,Felix Agu,GER,DF,Werder Bremen,25,1999.0,4.7,7,3,4,2,1,4,6,66.7,2,3,1,2,5,12,13,0
6,Kevin Akpoguma,NGA,DF,Hoffenheim,29,1995.0,5.0,10,2,8,1,1,5,7,71.4,2,16,11,5,1,11,21,0
7,Andreas Albers,DEN,FW,St. Pauli,34,1990.0,0.3,0,0,0,0,0,0,1,0.0,1,0,0,0,0,0,1,0
8,Skelly Alvero,FRA,MF,Werder Bremen,22,2002.0,0.5,3,3,3,0,0,1,1,100.0,0,2,0,2,1,4,5,0
9,Aurele Amenda,SUI,DF,Eint Frankfurt,21,2003.0,0.6,0,0,0,0,0,0,0,0.0,0,2,2,0,1,1,4,0
10,Nadiem Amiri,GER,MF,Mainz 05,27,1996.0,3.3,5,1,3,2,0,0,4,0.0,4,1,1,0,2,7,7,0
11,Mohamed Amoura,ALG,"FW,MF",Wolfsburg,24,2000.0,2.4,2,1,1,0,1,0,0,0.0,0,3,0,3,0,2,0,0
12,Robert Andrich,GER,MF,Leverkusen,30,1994.0,2.8,5,2,1,4,0,3,3,100.0,0,2,0,2,3,8,6,0
13,Waldemar Anton,GER,DF,Dortmund,28,1996.0,5.0,9,7,6,2,1,3,4,75.0,1,10,7,3,6,15,22,1
14,Maximilian Arnold,GER,MF,Wolfsburg,30,1994.0,4.9,9,7,2,5,2,3,7,42.9,4,4,3,1,2,11,9,0
15,Jann-Fiete Arp,GER,"FW,MF",Holstein Kiel,24,2000.0,1.5,4,4,2,1,1,1,2,50.0,1,1,0,1,0,4,0,0
16,Arthur,BRA,DF,Leverkusen,21,2003.0,0.1,0,0,0,0,0,0,0,0.0,0,0,0,0,1,1,1,0
17,Noah Atubolu,GER,GK,Freiburg,22,2002.0,3.0,0,0,0,0,0,0,0,0.0,0,0,0,0,0,0,2,1
18,Ridle Baku,GER,"FW,MF",Wolfsburg,26,1998.0,3.6,6,4,1,3,2,3,8,37.5,5,9,0,9,4,10,4,0
19,Aliou Baldé,GUI,"MF,FW",Bochum,21,2002.0,1.0,1,1,1,0,0,0,0,0.0,0,2,0,2,0,1,0,0
20,Samuel Bamba,GER,"FW,MF",Bochum,20,2004.0,0.1,0,0,0,0,0,0,0,0.0,0,0,0,0,0,0,0,0
21,Scott Banks,SCO,FW,St. Pauli,23,2001.0,0.2,0,0,0,0,0,0,0,0.0,0,0,0,0,1,1,1,0
22,Aymen Barkok,MAR,MF,Mainz 05,26,1998.0,0.8,2,1,1,1,0,1,1,100.0,0,1,1,0,2,4,0,0
23,Maximilian Bauer,GER,DF,Augsburg,24,2000.0,2.8,5,3,1,3,1,1,4,25.0,3,5,1,4,2,7,17,1
24,Oliver Baumann,GER,GK,Hoffenheim,34,1990.0,5.0,0,0,0,0,0,0,1,0.0,1,0,0,0,0,0,4,0
25,Christoph Baumgartner,AUT,"MF,DF",RB Leipzig,25,1999.0,1.2,2,2,1,1,0,2,6,33.3,4,3,1,2,0,2,1,0
26,Adrian Beck,GER,FW,Heidenheim,27,1997.0,2.3,3,2,1,2,0,0,5,0.0,5,9,0,9,3,6,5,0
27,Timo Becker,GER,DF,Holstein Kiel,27,1997.0,5.0,9,5,6,3,0,5,7,71.4,2,6,5,1,3,12,11,0
28,Kevin Behrens,GER,FW,Wolfsburg,33,1991.0,0.5,1,1,0,1,0,0,1,0.0,1,0,0,0,0,1,0,0
29,Maximilian Beier,GER,"FW,MF",Dortmund,21,2002.0,1.5,2,1,0,1,1,1,3,33.3,2,1,0,1,0,2,2,0
30,Stefan Bell,GER,DF,Mainz 05,33,1991.0,1.8,4,2,3,1,0,0,2,0.0,2,1,1,0,5,9,12,0
31,Jeanuël Belocian,FRA,DF,Leverkusen,19,2005.0,0.5,1,1,1,0,0,1,1,100.0,0,0,0,0,0,1,2,0
32,László Bénes,SVK,"MF,FW",Union Berlin,27,1997.0,1.5,0,0,0,0,0,0,1,0.0,1,1,1,0,0,0,1,0
33,Ramy Bensebaini,ALG,"DF,FW",Dortmund,29,1995.0,1.9,1,0,1,0,0,0,3,0.0,3,7,0,7,3,4,5,1
34,Mergim Berisha,GER,FW,Hoffenheim,26,1998.0,2.4,1,1,1,0,0,0,2,0.0,2,0,0,0,0,1,2,0
35,Alexander Bernhardsson,SWE,"DF,FW",Holstein Kiel,26,1998.0,1.7,1,1,0,0,1,1,1,100.0,0,2,0,2,0,1,2,0
36,Matúš Bero,SVK,MF,Bochum,29,1995.0,4.7,9,5,4,1,4,5,14,35.7,9,10,1,9,1,10,6,1
37,El Bilal Touré,MLI,"FW,MF",Stuttgart,22,2001.0,0.7,2,1,0,1,1,2,2,100.0,0,0,0,0,0,2,0,0
38,Tom Bischof,GER,MF,Hoffenheim,19,2005.0,2.1,9,6,2,7,0,3,5,60.0,2,4,2,2,1,10,6,0
39,Leonardo Bittencourt,GER,MF,Werder Bremen,30,1993.0,0.0,0,0,0,0,0,0,0,0.0,0,1,0,1,0,0,0,0
40,Myron Boadu,NED,"FW,MF",Bochum,23,2001.0,2.9,0,0,0,0,0,0,1,0.0,1,0,0,0,0,0,3,0
41,Sacha Boey,FRA,DF,Bayern Munich,24,2000.0,1.4,3,0,2,0,1,2,3,66.7,1,1,0,1,0,3,4,0
42,Victor Boniface,NGA,FW,Leverkusen,23,2000.0,3.8,2,2,0,2,0,1,1,100.0,0,1,0,1,0,2,3,0
43,Sebastiaan Bornauw,BEL,DF,Wolfsburg,25,1999.0,5.0,4,2,1,2,1,1,4,25.0,3,8,8,0,5,9,17,0
44,Carlo Boukhalfa,MAR,MF,St. Pauli,25,1999.0,2.6,6,1,0,5,1,0,2,0.0,2,3,0,3,3,9,2,0
45,Julian Brandt,GER,MF,Dortmund,28,1996.0,4.2,2,0,1,1,0,0,1,0.0,1,1,0,1,0,2,3,0
46,Tim Breithaupt,GER,MF,Augsburg,22,2002.0,1.3,1,1,0,1,0,0,4,0.0,4,1,0,1,2,3,0,0
47,Maximilian Breunig,GER,"FW,MF",Heidenheim,24,2000.0,2.4,3,2,0,2,1,2,3,66.7,1,4,2,2,1,4,3,0
48,Moritz Broschinski,GER,FW,Bochum,24,2000.0,2.8,3,2,1,2,0,0,2,0.0,2,3,0,3,0,3,4,0
49,Jacob Bruun Larsen,DEN,"DF,FW",Hoffenheim,26,1998.0,1.0,1,0,1,0,0,1,2,50.0,1,3,0,3,1,2,1,0
50,Marius Bülter,GER,FW,Hoffenheim,31,1993.0,4.0,5,5,1,3,1,5,6,83.3,1,1,1,0,1,6,2,0
51,Jonathan Burkardt,GER,"FW,MF",Mainz 05,24,2000.0,5.0,0,0,0,0,0,0,1,0.0,1,1,0,1,0,0,6,0
52,Marnon Busch,GER,DF,Heidenheim,29,1994.0,1.7,1,0,0,1,0,1,2,50.0,1,2,2,0,1,2,6,0
53,Anthony Caci,FRA,DF,Mainz 05,27,1997.0,4.2,4,2,1,2,1,2,4,50.0,2,5,0,5,4,8,12,1
54,Emre Can,GER,"MF,DF",Dortmund,30,1994.0,3.2,4,1,2,2,0,2,5,40.0,3,3,1,2,2,6,7,1
55,Julian Chabot,GER,DF,Stuttgart,26,1998.0,4.8,8,6,7,1,0,4,5,80.0,1,3,1,2,9,17,25,0
56,El Chadaille Bitshiabu,FRA,DF,RB Leipzig,19,2005.0,1.1,5,3,1,4,0,3,4,75.0,1,1,1,0,3,8,5,1
57,Fares Chaïbi,ALG,"FW,MF",Eint Frankfurt,21,2002.0,3.1,4,2,2,0,2,2,4,50.0,2,5,0,5,3,7,7,0
58,Anrie Chase,JPN,DF,Stuttgart,20,2004.0,2.5,2,0,0,2,0,0,0,0.0,0,5,3,2,5,7,10,0
59,Fabio Chiarodia,ITA,DF,Gladbach,19,2005.0,0.0,1,1,1,0,0,1,1,100.0,0,0,0,0,0,1,0,0
60,Nnamdi Collins,GER,DF,Eint Frankfurt,20,2004.0,0.0,0,0,0,0,0,0,0,0.0,0,0,0,0,0,0,0,0
61,Kingsley Coman,FRA,"FW,MF",Bayern Munich,28,1996.0,2.3,7,3,3,1,3,3,3,100.0,0,3,0,3,1,8,5,0
62,Sirlord Conteh,GER,"FW,DF",Heidenheim,28,1996.0,1.4,3,2,2,1,0,1,1,100.0,0,0,0,0,0,3,1,0
63,Yan Couto,BRA,DF,Dortmund,22,2002.0,1.6,2,1,2,0,0,2,5,40.0,3,4,0,4,1,3,3,0
64,Tomáš Čvančara,CZE,"FW,MF",Gladbach,24,2000.0,0.9,1,1,0,1,0,1,1,100.0,0,2,1,1,0,1,1,0
65,Mahmoud Dahoud,GER,MF,Eint Frankfurt,28,1996.0,0.6,1,0,1,0,0,0,0,0.0,0,0,0,0,0,1,0,0
66,Bence Dárdai,GER,FW,Wolfsburg,18,2006.0,0.1,0,0,0,0,0,0,0,0.0,0,0,0,0,1,1,0,0
67,Lukas Daschner,GER,"MF,FW",Bochum,25,1998.0,2.0,1,1,0,0,1,0,5,0.0,5,3,0,3,0,1,3,0
68,Alphonso Davies,CAN,DF,Bayern Munich,23,2000.0,3.3,5,1,2,1,2,4,4,100.0,0,3,0,3,2,7,4,0
69,Olivier Deman,BEL,DF,Werder Bremen,24,2000.0,0.2,2,1,0,2,0,1,2,50.0,1,0,0,0,0,2,2,0
70,Ermedin Demirović,BIH,FW,Stuttgart,26,1998.0,3.6,1,1,0,1,0,0,1,0.0,1,3,0,3,0,1,0,0
71,Justin Diehl,GER,DF,Stuttgart,19,2004.0,0.3,0,0,0,0,0,0,0,0.0,0,2,0,2,0,0,0,0
72,Eric Dier,ENG,DF,Bayern Munich,30,1994.0,0.1,0,0,0,0,0,0,0,0.0,0,0,0,0,0,0,1,0
73,Junior Dina Ebimbe,FRA,"FW,MF",Eint Frankfurt,23,2000.0,1.0,0,0,0,0,0,0,1,0.0,1,2,0,2,2,2,3,0
74,Eren Dinkçi,GER,MF,Freiburg,22,2001.0,2.1,2,1,0,1,1,0,4,0.0,4,4,1,3,1,3,0,0
75,Ritsu Doan,JPN,FW,Freiburg,26,1998.0,4.6,10,9,6,3,1,6,9,66.7,3,9,0,9,3,13,3,0
76,Danilho Doekhi,NED,DF,Union Berlin,26,1998.0,5.0,6,4,3,1,2,3,5,60.0,2,8,2,6,3,9,16,0
77,Niklas Dorsch,GER,MF,Augsburg,26,1998.0,0.4,0,0,0,0,0,0,0,0.0,0,1,0,1,0,0,0,0
78,Niklas Dorsch,GER,MF,Heidenheim,26,1998.0,1.4,0,0,0,0,0,0,1,0.0,1,3,0,3,0,0,2,0
79,Patrick Drewes,GER,GK,Bochum,31,1993.0,5.0,0,0,0,0,0,0,1,0.0,1,0,0,0,0,0,5,1
80,Tim Drexler,GER,DF,Hoffenheim,19,2005.0,3.5,17,7,11,6,0,9,12,75.0,3,6,4,2,1,18,7,0
81,Marvin Ducksch,GER,FW,Werder Bremen,30,1994.0,4.1,3,2,0,2,1,0,4,0.0,4,2,0,2,0,3,7,0
82,Julien Duranville,BEL,FW,Dortmund,18,2006.0,0.3,0,0,0,0,0,0,0,0.0,0,0,0,0,0,0,0,0
83,Adam Dźwigała,POL,"DF,MF",St. Pauli,29,1995.0,1.0,4,1,3,1,0,2,3,66.7,1,0,0,0,0,4,3,0
84,Johannes Eggestein,GER,FW,St. Pauli,26,1998.0,4.4,0,0,0,0,0,0,0,0.0,0,1,0,1,0,0,2,0
85,Maximilian Eggestein,GER,MF,Freiburg,27,1996.0,4.7,6,4,1,4,1,1,4,25.0,3,3,0,3,10,16,6,0
86,Hugo Ekitike,FRA,FW,Eint Frankfurt,22,2002.0,3.2,4,1,2,1,1,2,2,100.0,0,2,0,2,3,7,3,0
87,Nico Elvedi,SUI,DF,Gladbach,28,1996.0,5.0,9,5,4,2,3,6,6,100.0,0,10,8,2,8,17,18,0
88,Arne Engels,BEL,"MF,FW",Augsburg,21,2003.0,0.9,0,0,0,0,0,0,0,0.0,0,1,1,0,0,0,0,0
89,Patrick Erras,GER,DF,Holstein Kiel,29,1995.0,2.5,4,3,3,1,0,1,7,14.3,6,5,4,1,2,6,18,0
90,Samuel Essende,COD,FW,Augsburg,26,1998.0,3.6,0,0,0,0,0,0,0,0.0,0,3,1,2,0,0,1,0
91,Kilian Fischer,GER,DF,Wolfsburg,23,2000.0,5.0,16,12,12,2,2,12,26,46.2,14,10,0,10,5,21,16,1
92,Jonas Föhrenbach,GER,"DF,FW",Heidenheim,28,1996.0,5.0,10,9,5,5,0,5,8,62.5,3,5,1,4,6,16,14,0
93,Marco Friedl,AUT,DF,Werder Bremen,26,1998.0,2.7,6,5,3,3,0,2,4,50.0,2,2,2,0,5,11,15,0
94,Marvin Friedrich,GER,FW,Gladbach,28,1995.0,0.0,0,0,0,0,0,0,0,0.0,0,0,0,0,0,0,0,0
95,Jeremie Frimpong,NED,DF,Leverkusen,23,2000.0,3.7,6,5,4,1,1,4,10,40.0,6,4,0,4,4,10,2,0
96,Chris Führich,GER,"FW,MF",Stuttgart,26,1998.0,1.9,2,2,0,1,1,2,3,66.7,1,0,0,0,0,2,3,0
97,Aleix García,ESP,MF,Leverkusen,27,1997.0,2.1,3,0,1,1,1,2,3,66.7,1,2,0,2,1,4,2,0
98,Lutsharel Geertruida,NED,DF,RB Leipzig,24,2000.0,3.0,6,4,1,5,0,2,7,28.6,5,1,0,1,3,9,9,0
99,Dennis Geiger,GER,MF,Hoffenheim,26,1998.0,1.9,6,5,2,3,1,3,5,60.0,2,1,0,1,1,7,0,0
100,Valentin Gendrey,FRA,"DF,FW",Hoffenheim,24,2000.0,1.3,2,1,1,1,0,1,1,100.0,0,0,0,0,2,4,4,0
101,Yannick Gerhardt,GER,"FW,MF",Wolfsburg,30,1994.0,0.5,1,1,1,0,0,1,1,100.0,0,1,0,1,3,4,1,0
102,Max Geschwill,GER,DF,Holstein Kiel,23,2001.0,2.9,6,5,2,4,0,4,5,80.0,1,1,1,0,5,11,9,0
103,Dimitris Giannoulis,GRE,DF,Augsburg,28,1995.0,4.8,9,6,5,3,1,8,12,66.7,4,7,1,6,9,18,8,0
104,Armin Gigovic,BIH,MF,Holstein Kiel,22,2002.0,2.0,2,1,2,0,0,1,4,25.0,3,1,0,1,3,5,4,0
105,Benedikt Gimber,GER,DF,Heidenheim,27,1997.0,5.0,12,10,9,3,0,6,8,75.0,2,14,3,11,6,18,27,0
106,Matthias Ginter,GER,DF,Freiburg,30,1994.0,2.7,4,2,1,2,1,3,3,100.0,0,2,2,0,0,4,4,0
107,Jamie Gittens,ENG,"FW,DF",Dortmund,20,2004.0,2.5,6,2,1,3,2,0,1,0.0,1,3,0,3,2,8,0,0
108,Serge Gnabry,GER,"FW,MF",Bayern Munich,29,1995.0,3.6,5,5,3,1,1,3,6,50.0,3,2,0,2,3,8,2,0
109,Leon Goretzka,GER,DF,Bayern Munich,29,1995.0,0.0,0,0,0,0,0,0,0,0.0,0,0,0,0,0,0,2,0
110,Robin Gosens,GER,DF,Union Berlin,30,1994.0,1.0,0,0,0,0,0,0,3,0.0,3,1,0,1,1,1,2,0
111,Mario Götze,GER,"FW,MF",Eint Frankfurt,32,1992.0,2.5,3,3,1,2,0,1,4,25.0,3,2,0,2,1,4,2,0
112,Jeffrey Gouweleeuw,NED,DF,Augsburg,33,1991.0,5.0,5,3,2,1,2,3,7,42.9,4,5,1,4,4,9,19,0
113,Kamil Grabara,POL,GK,Wolfsburg,25,1999.0,5.0,0,0,0,0,0,0,1,0.0,1,1,0,1,0,0,2,0
114,Michael Gregoritsch,AUT,FW,Freiburg,30,1994.0,0.2,0,0,0,0,0,0,0,0.0,0,0,0,0,0,0,0,0
115,Vincenzo Grifo,ITA,"FW,MF",Freiburg,31,1993.0,4.5,1,1,1,0,0,0,4,0.0,4,3,1,2,0,1,1,0
116,Florian Grillitsch,AUT,"MF,DF",Hoffenheim,29,1995.0,2.3,6,5,3,2,1,3,3,100.0,0,2,2,0,1,7,8,0
117,Álex Grimaldo,ESP,DF,Leverkusen,29,1995.0,5.0,4,3,2,1,1,3,8,37.5,5,3,1,2,6,10,5,0
118,Pascal Groß,GER,MF,Dortmund,33,1991.0,4.5,7,4,1,5,1,0,7,0.0,7,3,0,3,2,9,4,0
119,Marco Grüll,AUT,"FW,MF",Werder Bremen,26,1998.0,1.5,2,2,0,1,1,0,2,0.0,2,4,1,3,1,3,1,0
120,Raphaël Guerreiro,POR,DF,Bayern Munich,30,1993.0,2.9,6,5,4,1,1,4,4,100.0,0,0,0,0,3,9,2,0
121,Morgan Guilavogui,GUI,FW,St. Pauli,26,1998.0,2.1,2,0,1,1,0,0,0,0.0,0,0,0,0,0,2,1,0
122,Serhou Guirassy,GUI,FW,Dortmund,28,1996.0,2.8,0,0,0,0,0,0,0,0.0,0,0,0,0,0,0,4,0
123,Péter Gulácsi,HUN,GK,RB Leipzig,34,1990.0,5.0,0,0,0,0,0,0,0,0.0,0,0,0,0,0,0,2,1
124,Christian Günter,GER,DF,Freiburg,31,1993.0,4.8,4,3,2,2,0,4,8,50.0,4,3,2,1,2,6,8,0
125,Janik Haberer,GER,"DF,MF",Union Berlin,30,1994.0,3.8,7,5,3,3,1,7,12,58.3,5,1,0,1,1,8,7,0
126,Robin Hack,GER,"FW,MF",Gladbach,26,1998.0,1.5,4,4,2,0,2,2,3,66.7,1,0,0,0,0,4,2,0
127,Amadou Haidara,MLI,MF,RB Leipzig,26,1998.0,3.2,6,5,3,3,0,3,5,60.0,2,9,3,6,2,8,13,0
128,Andreas Hanche-Olsen,NOR,DF,Mainz 05,27,1997.0,3.3,4,1,1,2,1,0,0,0.0,0,7,6,1,3,7,20,1
129,Ramon Hendriks,NED,DF,Stuttgart,23,2001.0,0.0,0,0,0,0,0,0,0,0.0,0,0,0,0,2,2,0,0
130,Benjamin Henrichs,GER,DF,RB Leipzig,27,1997.0,2.6,12,4,5,5,2,5,7,71.4,2,3,0,3,7,19,5,0
131,Piero Hincapié,ECU,DF,Leverkusen,22,2002.0,4.4,8,8,4,3,1,5,7,71.4,2,12,6,6,6,14,11,0
132,Adam Hložek,CZE,"FW,MF",Hoffenheim,22,2002.0,2.7,4,2,2,0,2,1,3,33.3,2,2,0,2,0,4,6,0
133,Nicolas Höfler,GER,MF,Freiburg,34,1990.0,0.6,2,2,1,1,0,1,2,50.0,1,0,0,0,1,3,2,0
134,Jonas Hofmann,GER,MF,Leverkusen,32,1992.0,0.7,0,0,0,0,0,0,0,0.0,0,0,0,0,0,0,1,0
135,Philipp Hofmann,GER,FW,Bochum,31,1993.0,3.5,1,0,1,0,0,0,2,0.0,2,1,0,1,0,1,3,0
136,Lucas Höler,GER,"MF,FW",Freiburg,30,1994.0,1.2,4,4,1,3,0,1,3,33.3,2,2,0,2,1,5,2,0
137,Benedict Hollerbach,GER,"MF,FW",Union Berlin,23,2001.0,3.9,7,3,1,4,2,4,4,100.0,0,6,0,6,0,7,0,0
138,Lewis Holtby,GER,MF,Holstein Kiel,34,1990.0,4.4,13,5,8,4,1,4,9,44.4,5,4,0,4,8,21,6,1
139,Franck Honorat,FRA,FW,Gladbach,28,1996.0,2.6,2,1,1,0,1,0,1,0.0,1,3,1,2,0,2,3,0
140,Mathias Honsak,AUT,"MF,FW",Heidenheim,27,1996.0,0.9,2,2,1,1,0,1,2,50.0,1,0,0,0,0,2,3,0
141,Lukáš Hrádecký,FIN,GK,Leverkusen,34,1989.0,4.0,0,0,0,0,0,0,0,0.0,0,0,0,0,0,0,1,1
142,Robin Hranáč,CZE,DF,Hoffenheim,24,2000.0,1.0,0,0,0,0,0,0,1,0.0,1,1,0,1,2,2,3,1
143,Hong Hyunseok,KOR,MF,Mainz 05,25,1999.0,2.4,4,1,2,1,1,0,1,0.0,1,1,0,1,3,7,5,0
144,Oscar Højlund,DEN,MF,Eint Frankfurt,19,2005.0,0.2,2,1,2,0,0,0,0,0.0,0,1,0,1,1,3,0,0
145,Jackson Irvine,AUS,MF,St. Pauli,31,1993.0,5.0,14,6,7,5,2,5,12,41.7,7,6,0,6,9,23,16,0
146,Ko Itakura,JPN,DF,Gladbach,27,1997.0,5.0,12,8,6,6,0,6,8,75.0,2,2,2,0,5,17,24,0
147,Marko Ivezić,SRB,DF,Holstein Kiel,22,2001.0,1.0,2,1,1,1,0,1,2,50.0,1,0,0,0,3,5,2,0
148,Lee Jae-sung,KOR,MF,Mainz 05,32,1992.0,3.8,7,5,3,2,2,1,1,100.0,0,5,1,4,2,9,7,0
149,Kristijan Jakić,CRO,MF,Augsburg,27,1997.0,2.9,4,0,1,2,1,0,3,0.0,3,5,0,5,3,7,1,0
150,Dominik Javorček,SVK,DF,Holstein Kiel,21,2002.0,0.5,1,0,1,0,0,1,1,100.0,0,1,1,0,1,2,4,1
151,Fredrik Jensen,FIN,"MF,DF",Augsburg,27,1997.0,1.2,0,0,0,0,0,0,0,0.0,0,1,0,1,0,0,1,0
152,Moritz Jenz,GER,DF,Mainz 05,25,1999.0,3.0,3,1,1,2,0,0,3,0.0,3,4,4,0,3,6,24,0
153,Carl Johansson,SWE,DF,Holstein Kiel,30,1994.0,3.9,4,2,4,0,0,3,6,50.0,3,7,6,1,6,10,23,1
154,Anthony Jung,GER,DF,Werder Bremen,32,1991.0,4.5,5,4,4,1,0,1,3,33.3,2,2,1,1,5,10,22,0
155,Yusuf Kabadayı,GER,"MF,FW",Augsburg,20,2004.0,0.4,1,0,0,1,0,0,0,0.0,0,1,0,1,0,1,0,0
156,Pavel Kadeřábek,CZE,DF,Hoffenheim,32,1992.0,4.8,7,3,4,1,2,5,12,41.7,7,5,2,3,6,13,13,0
157,Jakub Kamiński,POL,"DF,MF",Wolfsburg,22,2002.0,5.0,10,4,4,2,4,5,13,38.5,8,10,5,5,5,15,4,0
158,Kevin Kampl,SVN,MF,RB Leipzig,33,1990.0,2.9,6,4,2,2,2,3,4,75.0,1,6,1,5,3,9,3,0
159,Harry Kane,ENG,FW,Bayern Munich,31,1993.0,4.8,2,2,0,1,1,0,0,0.0,0,2,0,2,0,2,2,0
160,Atakan Karazor,GER,MF,Stuttgart,27,1996.0,4.4,10,2,1,5,4,5,5,100.0,0,1,0,1,4,14,5,0
161,Mikkel Kaufmann,DEN,FW,Heidenheim,23,2001.0,0.9,2,1,1,0,1,0,0,0.0,0,1,1,0,0,2,3,0
162,Andu Kelati,GER,MF,Holstein Kiel,22,2002.0,1.1,1,1,1,0,0,0,1,0.0,1,1,0,1,2,3,1,0
163,Aljoscha Kemlein,GER,MF,Union Berlin,20,2004.0,0.1,0,0,0,0,0,0,0,0.0,0,0,0,0,0,0,0,0
164,Luca Kerber,GER,"MF,FW",Heidenheim,22,2002.0,0.9,2,2,1,1,0,2,3,66.7,1,1,0,1,0,2,5,0
165,Rani Khedira,GER,MF,Union Berlin,30,1994.0,5.0,8,5,2,6,0,4,6,66.7,2,4,2,2,8,16,8,0
166,Joshua Kimmich,GER,"MF,DF",Bayern Munich,29,1995.0,5.0,5,2,2,2,1,5,7,71.4,2,2,0,2,4,9,7,2
167,Tim Kleindienst,GER,FW,Gladbach,29,1995.0,4.9,3,1,1,2,0,1,6,16.7,5,7,0,7,1,4,9,0
168,Lukas Klostermann,GER,DF,RB Leipzig,28,1996.0,3.2,5,2,4,0,1,3,5,60.0,2,6,3,3,2,7,16,1
169,Ansgar Knauff,GER,"MF,FW",Eint Frankfurt,22,2002.0,1.5,7,4,4,2,1,2,2,100.0,0,2,0,2,0,7,3,0
170,Magnus Knudsen,NOR,MF,Holstein Kiel,23,2001.0,4.7,13,5,6,3,4,7,13,53.8,6,4,2,2,5,18,10,0
171,Gregor Kobel,SUI,GK,Dortmund,26,1997.0,5.0,0,0,0,0,0,0,0,0.0,0,0,0,0,0,0,2,1
172,Robin Koch,GER,DF,Eint Frankfurt,28,1996.0,5.0,1,1,1,0,0,0,2,0.0,2,13,7,6,2,3,31,1
173,Derrick Köhn,GER,DF,Werder Bremen,25,1999.0,1.6,1,1,0,0,1,0,0,0.0,0,1,1,0,2,3,5,0
174,Dominik Kohr,GER,"DF,MF",Mainz 05,30,1994.0,4.8,16,11,11,2,3,10,13,76.9,3,13,7,6,4,20,26,0
175,Marco Komenda,CRO,DF,Holstein Kiel,27,1996.0,1.0,2,1,1,1,0,2,2,100.0,0,1,0,1,0,2,6,0
176,Mert Kömür,GER,MF,Augsburg,19,2005.0,0.3,0,0,0,0,0,0,0,0.0,0,1,1,0,0,0,0,1
177,Henri Koudossou,GER,DF,Augsburg,25,1999.0,0.3,1,1,0,1,0,1,3,33.3,2,1,1,0,0,1,2,0
178,Konstantinos Koulierakis,GRE,DF,Wolfsburg,20,2003.0,1.6,2,0,1,1,0,0,2,0.0,2,4,3,1,1,3,10,0
179,Matej Kovar,CZE,GK,Leverkusen,24,2000.0,1.0,0,0,0,0,0,0,0,0.0,0,0,0,0,0,0,0,0
180,Andrej Kramarić,CRO,MF,Hoffenheim,33,1991.0,3.9,0,0,0,0,0,0,1,0.0,1,3,1,2,0,0,1,0
181,Frans Krätzig,GER,DF,Stuttgart,21,2003.0,0.6,2,1,1,0,1,1,3,33.3,2,2,1,1,0,2,1,0
182,Rasmus Kristensen,DEN,"DF,MF",Eint Frankfurt,27,1997.0,5.0,11,6,7,2,2,7,15,46.7,8,6,3,3,3,14,15,0
183,Lukas Kübler,GER,DF,Freiburg,32,1992.0,4.5,9,6,6,2,1,5,7,71.4,2,8,3,5,13,22,9,1
184,Moritz-Broni Kwarteng,GHA,MF,Bochum,26,1998.0,0.7,0,0,0,0,0,0,1,0.0,1,0,0,0,0,0,0,0
185,Nediljko Labrović,CRO,GK,Augsburg,24,1999.0,5.0,0,0,0,0,0,0,0,0.0,0,0,0,0,0,0,6,0
186,Konrad Laimer,AUT,"DF,MF",Bayern Munich,27,1997.0,1.3,4,4,0,4,0,2,4,50.0,2,1,0,1,1,5,1,0
187,Stefan Lainer,AUT,DF,Gladbach,32,1992.0,0.1,0,0,0,0,0,0,0,0.0,0,0,0,0,0,0,0,0
188,Hugo Larsson,SWE,MF,Eint Frankfurt,20,2004.0,4.8,3,1,1,2,0,2,6,33.3,4,9,4,5,5,8,8,0
189,Diogo Leite,POR,DF,Union Berlin,25,1999.0,5.0,17,9,11,5,1,7,12,58.3,5,13,6,7,9,26,19,0
190,Maxim Leitsch,GER,DF,Mainz 05,26,1998.0,2.1,3,0,1,1,1,1,1,100.0,0,4,1,3,3,6,14,0
191,Jamie Leweling,GER,"FW,MF",Stuttgart,23,2001.0,4.7,2,1,1,0,1,1,3,33.3,2,5,0,5,2,4,5,0
192,Philipp Lienhart,AUT,DF,Freiburg,28,1996.0,4.5,2,2,1,1,0,1,4,25.0,3,2,2,0,4,6,12,1
193,Anthony Losilla,FRA,MF,Bochum,38,1986.0,3.1,7,7,3,4,0,3,8,37.5,5,8,2,6,6,13,5,0
194,Castello Lukeba,FRA,DF,RB Leipzig,21,2002.0,3.9,7,2,2,4,1,2,5,40.0,3,8,4,4,3,10,12,0
195,Senne Lynen,BEL,MF,Werder Bremen,25,1999.0,4.8,11,5,5,3,3,6,7,85.7,1,7,1,6,4,15,10,0
196,Shuto Machino,JPN,"FW,MF",Holstein Kiel,25,1999.0,3.7,2,2,1,0,1,2,4,50.0,2,0,0,0,2,4,2,0
197,Arne Maier,GER,MF,Augsburg,25,1999.0,1.9,1,0,0,1,0,1,1,100.0,0,3,0,3,0,1,0,0
198,Patrick Mainka,GER,DF,Heidenheim,29,1994.0,5.0,4,2,4,0,0,2,3,66.7,1,8,4,4,9,13,20,0
199,Lovro Majer,CRO,MF,Wolfsburg,26,1998.0,1.3,0,0,0,0,0,0,1,0.0,1,1,0,1,0,0,1,0
200,Jordy Makengo,FRA,DF,Freiburg,23,2001.0,0.2,2,2,2,0,0,2,2,100.0,0,0,0,0,0,2,1,0
201,Julián Malatini,ARG,DF,Werder Bremen,23,2001.0,1.4,5,5,3,2,0,2,3,66.7,1,1,1,0,2,7,5,0
202,Donyell Malen,NED,"FW,DF",Dortmund,25,1999.0,1.8,0,0,0,0,0,0,0,0.0,0,2,0,2,1,1,1,0
203,Lennard Maloney,USA,MF,Heidenheim,24,1999.0,3.2,6,3,4,2,0,5,7,71.4,2,3,0,3,4,10,16,0
204,Johan Manzambi,SUI,FW,Freiburg,18,2005.0,0.1,0,0,0,0,0,0,0,0.0,0,0,0,0,0,0,0,0
205,Omar Marmoush,EGY,"FW,MF",Eint Frankfurt,25,1999.0,4.6,4,2,0,2,2,0,1,0.0,1,4,1,3,0,4,1,0
206,Erhan Mašović,SRB,DF,Bochum,25,1998.0,3.2,3,3,2,1,0,2,4,50.0,2,6,5,1,4,7,14,0
207,Igor Matanovic,CRO,FW,Eint Frankfurt,21,2003.0,1.6,1,0,0,1,0,0,0,0.0,0,1,0,1,0,1,3,0
208,Chrislain Matsima,FRA,DF,Augsburg,22,2002.0,0.4,0,0,0,0,0,0,0,0.0,0,3,3,0,0,0,2,0
209,Jean Mattéo Bahoya,FRA,MF,Eint Frankfurt,19,2005.0,0.1,2,2,1,1,0,2,2,100.0,0,0,0,0,0,2,0,0
210,Keke Maximilian Topp,GER,"FW,MF",Werder Bremen,20,2004.0,1.3,1,0,0,0,1,0,0,0.0,0,0,0,0,1,2,0,0
211,Jakov Medić,CRO,DF,Bochum,26,1998.0,4.8,4,3,2,2,0,2,6,33.3,4,10,8,2,6,10,33,1
212,Connor Metcalfe,AUS,MF,St. Pauli,24,1999.0,2.5,1,0,0,1,0,0,3,0.0,3,3,0,3,2,3,4,0
213,Karol Mets,EST,DF,St. Pauli,31,1993.0,5.0,5,2,3,2,0,1,3,33.3,2,4,1,3,4,9,33,0
214,Florian Micheler,AUT,MF,Hoffenheim,19,2005.0,0.4,0,0,0,0,0,0,2,0.0,2,0,0,0,0,0,0,0
215,Enzo Millot,FRA,MF,Stuttgart,22,2002.0,3.9,4,4,0,2,2,2,9,22.2,7,7,0,7,3,7,0,0
216,Kim Min-jae,KOR,DF,Bayern Munich,27,1996.0,4.9,6,3,1,5,0,1,2,50.0,1,6,2,4,10,16,9,1
217,Maximilian Mittelstädt,GER,DF,Stuttgart,27,1997.0,4.1,10,6,6,4,0,7,12,58.3,5,10,4,6,7,17,12,0
218,Koji Miyoshi,JPN,MF,Bochum,27,1997.0,0.9,2,2,0,1,1,0,1,0.0,1,2,1,1,0,2,1,0
219,Max Moerstedt,GER,FW,Hoffenheim,,0.0,0.3,0,0,0,0,0,0,0,0.0,0,0,0,0,0,0,1,0
220,Steve Mounié,BEN,FW,Augsburg,30,1994.0,1.3,1,1,0,0,1,0,0,0.0,0,0,0,0,0,1,1,0
221,Nordi Mukiele,FRA,DF,Leverkusen,26,1997.0,0.6,2,2,0,1,1,2,2,100.0,0,1,0,1,1,3,2,1
222,Florian Müller,GER,GK,Freiburg,26,1997.0,2.0,0,0,0,0,0,0,0,0.0,0,0,0,0,0,0,0,0
223,Kevin Müller,GER,GK,Heidenheim,33,1991.0,5.0,0,0,0,0,0,0,0,0.0,0,0,0,0,0,0,2,0
224,Thomas Müller,GER,"MF,FW",Bayern Munich,35,1989.0,1.4,0,0,0,0,0,0,1,0.0,1,2,0,2,0,0,1,0
225,Jamal Musiala,GER,MF,Bayern Munich,21,2003.0,4.3,7,5,2,3,2,1,6,16.7,5,4,0,4,3,10,2,0
226,Florent Muslija,KVX,"DF,FW",Freiburg,26,1998.0,0.6,4,3,3,0,1,2,2,100.0,0,0,0,0,0,4,0,0
227,Phillipp Mwene,AUT,DF,Mainz 05,30,1994.0,4.9,9,4,2,6,1,2,5,40.0,3,4,1,3,5,14,12,0
228,Nathan N'Goumou,FRA,FW,Gladbach,24,2000.0,2.4,5,5,3,1,1,2,4,50.0,2,5,0,5,2,7,3,0
229,Stanley N'Soki,FRA,DF,Hoffenheim,25,1999.0,0.2,1,0,1,0,0,0,0,0.0,0,1,0,1,0,1,3,0
230,Paul Nebel,GER,DF,Mainz 05,21,2002.0,0.4,2,0,1,0,1,2,2,100.0,0,2,0,2,2,4,3,0
231,Luca Netz,GER,DF,Gladbach,21,2003.0,4.9,12,6,9,2,1,5,9,55.6,4,8,2,6,6,18,12,0
232,Manuel Neuer,GER,GK,Bayern Munich,38,1986.0,4.0,0,0,0,0,0,0,0,0.0,0,0,0,0,0,0,2,1
233,Florian Neuhaus,GER,MF,Gladbach,27,1997.0,0.3,1,0,1,0,0,0,4,0.0,4,0,0,0,1,2,0,0
234,Moritz Nicolas,GER,GK,Gladbach,26,1997.0,2.0,0,0,0,0,0,0,0,0.0,0,0,0,0,0,0,1,0
235,Justin Njinmah,GER,"MF,FW",Werder Bremen,23,2000.0,1.5,1,1,1,0,0,1,1,100.0,0,0,0,0,2,3,0,0
236,Niels Nkounkou,FRA,"MF,DF",Eint Frankfurt,23,2000.0,1.9,1,1,1,0,0,0,1,0.0,1,2,1,1,3,4,2,0
237,Felix Nmecha,GER,"MF,DF",Dortmund,23,2000.0,1.8,3,3,0,2,1,2,3,66.7,1,1,0,1,2,5,5,0
238,Alexander Nübel,GER,GK,Stuttgart,28,1996.0,5.0,0,0,0,0,0,0,0,0.0,0,0,0,0,0,0,1,0
239,Antonio Nusa,NOR,MF,RB Leipzig,19,2005.0,2.0,6,3,4,1,1,3,4,75.0,1,5,0,5,1,7,4,0
240,Tim Oermann,GER,DF,Bochum,20,2003.0,1.2,1,1,1,0,0,0,1,0.0,1,2,2,0,3,4,2,0
241,Ifechukwu Ogbus,SUI,DF,Freiburg,18,2005.0,0.2,1,1,0,0,1,0,1,0.0,1,0,0,0,1,2,2,0
242,Michael Olise,FRA,"FW,MF",Bayern Munich,22,2001.0,3.6,6,4,2,3,1,3,6,50.0,3,3,0,3,1,7,2,0
243,Jonas Omlin,SUI,GK,Gladbach,30,1994.0,3.0,0,0,0,0,0,0,0,0.0,0,0,0,0,0,0,0,0
244,Karim Onisiwo,AUT,"MF,FW",Mainz 05,32,1992.0,1.0,0,0,0,0,0,0,0,0.0,0,0,0,0,0,0,0,0
245,Frank Onyeka,NGA,MF,Augsburg,26,1998.0,2.9,9,8,4,3,2,3,4,75.0,1,4,2,2,6,15,3,0
246,Loïs Openda,BEL,FW,RB Leipzig,24,2000.0,4.2,0,0,0,0,0,0,1,0.0,1,2,0,2,0,0,0,0
247,Willi Orban,HUN,DF,RB Leipzig,31,1992.0,2.9,5,4,3,2,0,4,5,80.0,1,4,3,1,4,9,11,0
248,Patrick Osterhage,GER,MF,Freiburg,24,2000.0,4.0,9,6,4,4,1,3,8,37.5,5,4,0,4,9,18,3,0
249,Salih Özcan,TUR,MF,Wolfsburg,26,1998.0,1.3,1,1,0,0,1,0,4,0.0,4,5,1,4,2,3,1,0
250,Exequiel Palacios,ARG,MF,Leverkusen,25,1998.0,0.1,0,0,0,0,0,0,0,0.0,0,0,0,0,0,0,0,0
251,João Palhinha,POR,MF,Bayern Munich,29,1995.0,1.4,1,1,1,0,0,0,2,0.0,2,4,0,4,2,3,1,0
252,Mats Pannewig,GER,MF,Bochum,19,2004.0,0.4,0,0,0,0,0,0,0,0.0,0,3,0,3,0,0,2,0
253,Felix Passlack,GER,DF,Bochum,26,1998.0,5.0,9,5,5,2,2,5,10,50.0,5,11,4,7,4,13,11,0
254,Aleksandar Pavlovic,GER,MF,Bayern Munich,20,2004.0,3.6,10,5,2,5,3,4,6,66.7,2,5,1,4,0,10,3,0
255,Mads Pedersen,DEN,DF,Augsburg,28,1996.0,1.8,5,4,3,1,1,3,3,100.0,0,3,0,3,1,6,5,0
256,Jordan Pefok,USA,FW,Union Berlin,28,1996.0,3.7,3,2,2,0,1,0,2,0.0,2,2,0,2,2,5,5,0
257,Benedikt Pichler,AUT,FW,Holstein Kiel,27,1997.0,4.6,3,2,1,0,2,1,2,50.0,1,3,1,2,1,4,5,0
258,Amos Pieper,GER,DF,Werder Bremen,26,1998.0,1.2,2,1,1,0,1,0,3,0.0,3,2,2,0,5,7,4,0
259,Marvin Pieringer,GER,FW,Heidenheim,24,1999.0,3.8,2,0,0,1,1,1,2,50.0,1,5,0,5,1,3,4,0
260,Alassane Pléa,FRA,FW,Gladbach,31,1993.0,3.0,1,1,0,1,0,1,1,100.0,0,1,0,1,0,1,1,1
261,Finn Porath,GER,"DF,MF",Holstein Kiel,27,1997.0,3.8,4,1,3,0,1,2,7,28.6,5,7,3,4,2,6,9,0
262,Yussuf Poulsen,DEN,FW,RB Leipzig,30,1994.0,1.0,1,1,1,0,0,1,3,33.3,2,2,2,0,0,1,1,0
263,Alexander Prass,AUT,DF,Hoffenheim,23,2001.0,3.9,4,2,4,0,0,4,9,44.4,5,4,1,3,1,5,8,1
264,Grischa Prömel,GER,MF,Hoffenheim,29,1995.0,1.9,0,0,0,0,0,0,1,0.0,1,1,1,0,2,2,4,0
265,Tymoteusz Puchacz,POL,DF,Holstein Kiel,25,1999.0,1.6,3,2,2,1,0,1,2,50.0,1,4,1,3,0,3,5,0
266,Leopold Querfeld,AUT,DF,Union Berlin,20,2003.0,0.9,2,0,2,0,0,2,3,66.7,1,2,1,1,1,3,11,0
267,David Raum,GER,DF,RB Leipzig,26,1998.0,4.6,11,8,5,4,2,2,5,40.0,3,4,1,3,2,13,10,0
268,Rocco Reitz,GER,MF,Gladbach,22,2002.0,2.4,9,3,6,3,0,6,6,100.0,0,4,2,2,8,17,4,0
269,Nicolai Remberg,GER,MF,Holstein Kiel,24,2000.0,1.8,6,3,3,3,0,2,3,66.7,1,3,0,3,0,6,4,0
270,Elvis Rexhbeçaj,KVX,MF,Augsburg,26,1997.0,4.6,4,3,0,3,1,3,9,33.3,6,7,1,6,2,6,5,0
271,Gio Reyna,USA,MF,Dortmund,21,2002.0,0.1,1,0,0,0,1,1,1,100.0,0,0,0,0,0,1,0,0
272,Fabian Rieder,SUI,"MF,FW",Stuttgart,22,2002.0,2.6,4,3,1,2,1,2,6,33.3,4,3,0,3,3,7,0,0
273,Lars Ritzka,GER,"DF,FW",St. Pauli,26,1998.0,2.2,10,7,3,4,3,5,10,50.0,5,6,0,6,0,10,5,0
274,Merlin Röhl,GER,MF,Freiburg,22,2002.0,1.8,3,3,1,2,0,1,1,100.0,0,1,0,1,1,4,0,0
275,Lasse Rosenboom,GER,DF,Holstein Kiel,22,2002.0,1.7,4,3,4,0,0,2,3,66.7,1,3,1,2,2,6,7,0
276,Max Rosenfelder,GER,DF,Freiburg,21,2003.0,3.0,6,4,5,1,0,4,4,100.0,0,4,1,3,2,8,17,0
277,Tom Rothe,GER,"DF,MF",Union Berlin,19,2004.0,3.2,10,3,9,1,0,3,6,50.0,3,8,3,5,2,12,7,1
278,Anthony Rouault,FRA,DF,Stuttgart,23,2001.0,2.3,2,1,1,1,0,2,2,100.0,0,3,1,2,2,4,8,0
279,Julian Ryerson,NOR,DF,Dortmund,26,1997.0,4.3,3,3,1,1,1,3,6,50.0,3,4,1,3,5,8,4,0
280,Frederik Rønnow,DEN,GK,Union Berlin,32,1992.0,5.0,0,0,0,0,0,0,0,0.0,0,0,0,0,0,0,5,0
281,Elias Saad,TUN,"FW,MF",St. Pauli,24,1999.0,2.8,9,6,4,3,2,4,9,44.4,5,6,0,6,0,9,1,0
282,Marcel Sabitzer,AUT,"MF,FW",Dortmund,30,1994.0,3.2,5,3,0,5,0,3,6,50.0,3,6,3,3,1,6,4,0
283,Manolis Saliakas,GRE,MF,St. Pauli,28,1996.0,2.3,5,3,3,0,2,2,4,50.0,2,2,0,2,1,6,8,0
284,Roland Sallai,HUN,"FW,MF",Freiburg,27,1997.0,0.5,2,1,1,1,0,0,0,0.0,0,0,0,0,1,3,0,0
285,Philipp Sander,GER,MF,Gladbach,26,1998.0,2.7,7,3,3,3,1,2,3,66.7,1,6,1,5,4,11,3,0
286,Leroy Sané,GER,FW,Bayern Munich,28,1996.0,0.4,0,0,0,0,0,0,0,0.0,0,0,0,0,0,0,0,0
287,Kaishu Sano,JPN,MF,Mainz 05,23,2000.0,4.8,9,6,4,4,1,3,8,37.5,5,8,3,5,4,13,7,0
288,Kauã Santos,BRA,GK,Eint Frankfurt,21,2003.0,2.5,0,0,0,0,0,0,0,0.0,0,0,0,0,0,0,2,0
289,Joe Scally,USA,DF,Gladbach,21,2002.0,5.0,10,6,8,2,0,5,7,71.4,2,2,1,1,1,11,10,1
290,András Schäfer,HUN,MF,Union Berlin,25,1999.0,3.9,12,6,6,5,1,9,13,69.2,4,6,1,5,4,16,8,0
291,Patrik Schick,CZE,FW,Leverkusen,28,1996.0,1.0,1,1,0,1,0,0,0,0.0,0,0,0,0,0,1,1,0
292,Stefan Schimmer,GER,FW,Heidenheim,30,1994.0,0.3,0,0,0,0,0,0,0,0.0,0,0,0,0,0,0,0,0
293,Keven Schlotterbeck,GER,DF,Augsburg,27,1997.0,4.6,4,3,1,3,0,2,2,100.0,0,4,3,1,6,10,17,1
294,Nico Schlotterbeck,GER,DF,Dortmund,24,1999.0,3.8,9,6,5,4,0,7,11,63.6,4,3,0,3,7,16,10,0
295,Romano Schmid,AUT,MF,Werder Bremen,24,2000.0,4.8,6,1,2,3,1,4,11,36.4,7,5,0,5,0,6,3,0
296,Jan Schöppner,GER,MF,Heidenheim,25,1999.0,4.2,9,4,2,6,1,5,8,62.5,3,6,1,5,7,16,20,0
297,Marvin Schulz,GER,MF,Holstein Kiel,29,1995.0,0.1,0,0,0,0,0,0,1,0.0,1,1,1,0,0,0,1,0
298,Léo Scienza,BRA,"FW,MF",Heidenheim,26,1998.0,2.7,2,2,2,0,0,0,4,0.0,4,1,0,1,3,5,4,0
299,Nicolas Seiwald,AUT,MF,RB Leipzig,23,2001.0,3.4,10,8,3,7,0,4,8,50.0,4,3,1,2,7,17,8,0
300,Benjamin Šeško,SVN,"FW,MF",RB Leipzig,21,2003.0,4.0,3,1,0,1,2,1,1,100.0,0,3,1,2,2,5,4,0
301,Armindo Sieb,GER,"MF,FW",Mainz 05,21,2003.0,1.5,1,0,0,1,0,1,2,50.0,1,1,0,1,0,1,1,0
302,Tim Siersleben,GER,DF,Heidenheim,24,2000.0,0.1,0,0,0,0,0,0,0,0.0,0,0,0,0,1,1,2,0
303,Kiliann Sildillia,FRA,FW,Freiburg,22,2002.0,0.0,0,0,0,0,0,0,0,0.0,0,0,0,0,0,0,0,0
304,André Silva,POR,FW,RB Leipzig,28,1995.0,0.2,0,0,0,0,0,0,0,0.0,0,0,0,0,0,0,0,0
305,Mohamed Simakan,FRA,DF,RB Leipzig,24,2000.0,0.6,0,0,0,0,0,0,0,0.0,0,0,0,0,2,2,0,0
306,Xavi Simons,NED,MF,RB Leipzig,21,2003.0,5.0,5,4,0,5,0,2,2,100.0,0,3,1,2,1,6,2,0
307,Danel Sinani,LUX,FW,St. Pauli,27,1997.0,0.0,0,0,0,0,0,0,1,0.0,1,0,0,0,0,0,0,0
308,Ibrahima Sissoko,MLI,"MF,DF",Bochum,26,1997.0,4.8,14,10,7,6,1,6,11,54.5,5,3,2,1,6,20,11,0
309,Tim Skarke,GER,"FW,MF",Union Berlin,28,1996.0,1.6,2,2,1,1,0,2,4,50.0,2,1,0,1,0,2,3,0
310,Ellyes Skhiri,TUN,MF,Eint Frankfurt,29,1995.0,4.1,4,3,2,2,0,0,7,0.0,7,10,1,9,5,9,7,0
311,Steven Skrzybski,GER,MF,Holstein Kiel,31,1992.0,0.6,0,0,0,0,0,0,0,0.0,0,0,0,0,2,2,1,0
312,Eric Smith,SWE,DF,St. Pauli,27,1997.0,4.4,4,3,4,0,0,3,3,100.0,0,6,3,3,7,11,15,1
313,Anton Stach,GER,"DF,MF",Hoffenheim,25,1998.0,4.5,12,10,6,5,1,6,8,75.0,2,7,3,4,3,15,25,0
314,Jens Stage,DEN,MF,Werder Bremen,27,1996.0,4.7,5,5,3,2,0,2,8,25.0,6,10,2,8,6,11,7,0
315,Niklas Stark,GER,DF,Werder Bremen,29,1995.0,4.1,9,6,4,4,1,4,5,80.0,1,10,8,2,4,13,24,0
316,Pascal Stenzel,GER,DF,Stuttgart,28,1996.0,1.3,1,0,1,0,0,0,1,0.0,1,3,1,2,0,1,4,0
317,Angelo Stiller,GER,"MF,DF",Stuttgart,23,2001.0,4.9,5,1,2,2,1,2,4,50.0,2,7,3,4,4,9,12,1
318,Kevin Stöger,AUT,MF,Gladbach,31,1993.0,4.6,8,4,3,3,2,3,10,30.0,7,7,0,7,3,11,11,0
319,Niklas Süle,GER,DF,Dortmund,29,1995.0,3.7,5,4,4,1,0,4,5,80.0,1,1,1,0,1,6,19,0
320,Mattias Svanberg,SWE,MF,Wolfsburg,25,1999.0,4.2,6,3,0,5,1,1,3,33.3,2,1,0,1,4,10,4,0
321,Haris Tabakovic,BIH,FW,Hoffenheim,30,1994.0,0.4,0,0,0,0,0,0,0,0.0,0,0,0,0,0,0,0,0
322,Jonathan Tah,GER,DF,Leverkusen,28,1996.0,5.0,4,3,3,1,0,2,2,100.0,0,3,2,1,5,9,15,1
323,Edmond Tapsoba,BFA,DF,Leverkusen,25,1999.0,4.9,14,11,7,6,1,5,9,55.6,4,2,2,0,2,16,13,0
324,Mathys Tel,FRA,"MF,FW",Bayern Munich,19,2005.0,0.8,0,0,0,0,0,0,0,0.0,0,0,0,0,1,1,0,0
325,Nathan Tella,NGA,"DF,FW",Leverkusen,25,1999.0,0.9,0,0,0,0,0,0,1,0.0,1,1,0,1,0,0,1,0
326,Martin Terrier,FRA,MF,Leverkusen,27,1997.0,3.0,2,1,0,0,2,1,2,50.0,1,2,0,2,1,3,1,0
327,Arthur Theate,BEL,DF,Eint Frankfurt,24,2000.0,4.8,4,2,1,3,0,2,7,28.6,5,9,8,1,5,9,25,0
328,Phillip Tietz,GER,FW,Augsburg,27,1997.0,2.8,3,2,1,2,0,1,1,100.0,0,1,0,1,1,4,5,0
329,Umut Tohumcu,GER,MF,Hoffenheim,20,2004.0,1.5,5,4,2,2,1,2,2,100.0,0,2,0,2,1,6,2,0
330,Tiago Tomás,POR,"MF,FW",Wolfsburg,22,2002.0,4.1,7,4,5,1,1,4,13,30.8,9,3,0,3,4,11,5,0
331,Lucas Tousart,FRA,MF,Union Berlin,27,1997.0,1.4,1,1,0,1,0,0,2,0.0,2,3,1,2,1,2,2,0
332,Omar Traoré,GER,"DF,FW",Heidenheim,26,1998.0,4.8,11,6,9,2,0,7,8,87.5,1,2,2,0,1,12,9,0
333,Kevin Trapp,GER,GK,Eint Frankfurt,34,1990.0,2.5,0,0,0,0,0,0,0,0.0,0,0,0,0,0,0,0,0
334,Philipp Treu,GER,"MF,DF",St. Pauli,23,2000.0,5.0,9,5,6,2,1,5,9,55.6,4,12,0,12,2,11,7,0
335,Christopher Trimmel,AUT,DF,Union Berlin,37,1987.0,1.2,3,2,2,1,0,2,3,66.7,1,0,0,0,1,4,5,0
336,Tuta,BRA,"DF,MF",Eint Frankfurt,25,1999.0,5.0,13,8,9,3,1,9,12,75.0,3,12,7,5,4,17,31,0
337,Sven Ulreich,GER,GK,Bayern Munich,36,1988.0,1.0,0,0,0,0,0,0,0,0.0,0,0,0,0,0,0,0,0
338,Deniz Undav,GER,"FW,MF",Stuttgart,28,1996.0,3.6,3,3,0,1,2,0,0,0.0,0,2,0,2,0,3,1,0
339,Dayot Upamecano,FRA,DF,Bayern Munich,25,1998.0,5.0,9,6,2,6,1,5,8,62.5,3,3,1,2,9,18,10,0
340,Can Uzun,TUR,"FW,MF",Eint Frankfurt,18,2005.0,0.6,2,1,1,0,1,1,2,50.0,1,0,0,0,0,2,0,0
341,Josha Vagnoman,GER,DF,Stuttgart,23,2000.0,3.0,3,1,2,1,0,0,0,0.0,0,3,1,2,3,6,7,0
342,Ruben Vargas,SUI,MF,Augsburg,26,1998.0,2.6,2,1,1,1,0,1,4,25.0,3,1,0,1,1,3,0,1
343,Nikola Vasilj,BIH,GK,St. Pauli,28,1995.0,5.0,0,0,0,0,0,0,0,0.0,0,0,0,0,0,0,1,0
344,Denis Vavro,SVK,DF,Wolfsburg,28,1996.0,0.0,0,0,0,0,0,0,0,0.0,0,0,0,0,0,0,0,0
345,Miloš Veljković,SRB,DF,Werder Bremen,29,1995.0,1.0,0,0,0,0,0,0,1,0.0,1,1,1,0,0,0,2,0
346,Nikolas Veratschnig,AUT,MF,Mainz 05,21,2003.0,0.0,0,0,0,0,0,0,0,0.0,0,0,0,0,0,0,0,0
347,Arthur Vermeeren,BEL,MF,RB Leipzig,19,2005.0,0.8,2,1,2,0,0,2,4,50.0,2,2,1,1,1,3,2,0
348,Yorbe Vertessen,BEL,"MF,FW",Union Berlin,23,2001.0,2.0,2,1,1,1,0,0,1,0.0,1,2,0,2,0,2,1,0
349,Kevin Vogt,GER,DF,Union Berlin,33,1991.0,4.9,1,1,0,1,0,0,3,0.0,3,3,1,2,2,3,24,0
350,Aster Vranckx,BEL,MF,Wolfsburg,21,2002.0,0.6,1,1,1,0,0,0,0,0.0,0,0,0,0,2,3,0,0
351,Robert Wagner,GER,MF,St. Pauli,21,2003.0,2.0,6,2,1,5,0,2,6,33.3,4,5,0,5,0,6,3,0
352,Hauke Wahl,GER,DF,St. Pauli,30,1994.0,5.0,6,3,1,5,0,3,4,75.0,1,4,1,3,5,11,18,0
353,Paul Wanner,GER,MF,Heidenheim,18,2005.0,3.9,10,6,2,8,0,4,8,50.0,4,2,0,2,1,11,5,0
354,Julian Weigl,GER,MF,Gladbach,29,1995.0,4.6,9,4,6,2,1,6,7,85.7,1,5,2,3,11,20,10,0
355,Timon Weiner,GER,GK,Holstein Kiel,25,1999.0,5.0,0,0,0,0,0,0,0,0.0,0,0,0,0,0,0,3,0
356,Nelson Weiper,GER,"FW,MF",Mainz 05,19,2005.0,0.2,0,0,0,0,0,0,0,0.0,0,1,0,1,0,0,0,0
357,Mitchell Weiser,GER,"DF,MF",Werder Bremen,30,1994.0,5.0,9,5,3,6,0,4,9,44.4,5,2,0,2,2,11,11,0
358,Noah Weißhaupt,GER,FW,Freiburg,23,2001.0,0.6,0,0,0,0,0,0,1,0.0,1,0,0,0,0,0,1,0
359,Silvan Widmer,SUI,DF,Mainz 05,31,1993.0,1.2,2,2,1,1,0,2,3,66.7,1,1,0,1,1,3,4,0
360,Patrick Wimmer,AUT,"FW,MF",Wolfsburg,23,2001.0,3.3,3,3,1,2,0,2,6,33.3,4,4,0,4,4,7,1,0
361,Jonas Wind,DEN,"FW,MF",Wolfsburg,25,1999.0,1.5,0,0,0,0,0,0,0,0.0,0,1,0,1,0,0,0,0
362,Florian Wirtz,GER,MF,Leverkusen,21,2003.0,5.0,9,5,4,4,1,3,6,50.0,3,7,1,6,3,12,0,0
363,Dani de Wit,NED,MF,Bochum,26,1998.0,4.0,7,5,4,3,0,3,9,33.3,6,5,1,4,5,12,9,0
364,Maximilian Wittek,GER,DF,Bochum,29,1995.0,5.0,8,7,4,4,0,8,14,57.1,6,14,3,11,9,17,17,0
365,Marius Wolf,GER,DF,Augsburg,29,1995.0,2.9,2,0,0,1,1,0,3,0.0,3,4,0,4,1,3,6,0
366,Nick Woltemade,GER,MF,Stuttgart,22,2002.0,0.2,0,0,0,0,0,0,0,0.0,0,0,0,0,0,0,0,0
367,Jeong Woo-yeong,KOR,"MF,FW",Union Berlin,25,1999.0,1.7,0,0,0,0,0,0,0,0.0,0,0,0,0,1,1,0,0
368,Granit Xhaka,SUI,MF,Leverkusen,32,1992.0,5.0,6,3,1,4,1,3,4,75.0,1,6,3,3,1,7,5,0
369,Dan-Axel Zagadou,FRA,"DF,MF",Stuttgart,25,1999.0,0.3,0,0,0,0,0,0,0,0.0,0,0,0,0,1,1,1,0
370,Robin Zentner,GER,GK,Mainz 05,29,1994.0,5.0,0,0,0,0,0,0,0,0.0,0,0,0,0,0,0,10,1
371,Cedric Zesiger,SUI,DF,Wolfsburg,26,1998.0,5.0,10,6,3,5,2,4,9,44.4,5,5,5,0,3,13,24,0
372,Michael Zetterer,GER,GK,Werder Bremen,29,1995.0,5.0,0,0,0,0,0,0,0,0.0,0,0,0,0,0,0,1,1
